TTTTTTTTTTTTTTTTTTTTTTTTTTTTTT
T                   T   T    T
T      TTTTTTTTTT   T   T TT T
T      T                     T
T      T TTTT TTTTTTTTTTT  TTT
T             T              T
T  TTT  TTTTTTT              T
T       T     TTTTTTTTTTTTTTTT
T  TTT  T                    .
T       T  T  TTTTTTTTTTTTTTTT
T  TTT  T  T  T              T
T       T  T  T   TTTTTTT  TTT
T       T  T  T   T  T       T
T  TTT  T  T  T   T  T  TTT  T
T                 T  T   T   T
T  TTTTTTTTTTTT   T  T   T   T
T                            T
TTTTTTTTTTTTTTTTTTTTTTTTTTTTTT